
NO ./textures_xpm/naturalbricks_hd_verydark.xpm
SO ./textures_xpm/naturalbricks_hd_verydark.xpm
EA ./textures_xpm/naturalbricks_hd_verydark.xpm
WE ./textures_xpm/naturalbricks_hd_verydark.xpm

C 155,100,160
F 111,111,111

1111111111111111
10000000000000001
10100000100000101
10000000000000001
10001000100010001
1000000000000000111111111
1111111110101010N01010101
10000000000000001111111 1
10001000100100001111111 1
10000000000000001111111 1
10100000100001001
10000000000000001
11111111111111111
