
NO ./textures_xpm/naturalbricks_hd_verydark.xpm
SO ./textures_xpm/naturalbricks_hd_verydark.xpm
EA ./textures_xpm/naturalbricks_hd_verydark.xpm
WE ./textures_xpm/naturalbricks_hd_verydark.xpm

C 155,100,160
F 111,111,111

11111111111111111
10000000000000001
10100000100000101
10000000000000001
10001000100010001
1000000000000000111
10101010N01010101001
10000000000000001111
10001000100100001
100000000000000011111111111111111111111111111111111111111
101000001000010010000000000000000000000000000000000010
100000000000000011111111111111111111111111111111111111111
11111111111111111
