
NO ./textures_xpm/naturalbricks_hd_verydark.xpm
SO ./textures_xpm/naturalbricks_hd_verydark.xpm
EA ./textures_xpm/naturalbricks_hd_verydark.xpm
WE ./textures_xpm/naturalbricks_hd_verydark.xpm

C 155,100,160
F 111,111,111

11111111111111111
10000000000000001
10100000100000101
10000000000000001
10001000100010001
10000000W00000001
10101010101010101
1000000000000000111 1
100010001001000010101
10000000000000001111
10100000100001001
10000000000000001
11111111111111111
