
EA ../textures_xpm/naturalbricks_hd_verydark.xpm
NO ./textures_xpm/naturalbricks_hd_verydark.xpm
SO ./textures_xpm/naturalbricks_hd_verydark.xpm
WE ./textures_xpm/naturalbricks_hd_verydark.xpm

C 155,100,160
F 111,111,111

111111111111111111111111111111111111
10000000000000001000001
101000001000001011111 1
100000000000000011111 1
100010001000100011111 1
10000000000000001
10101010N01010101
10000000000000001
10001000100100001
10000000000000001
10100000100001001
10000000000000001
11111111111111111
