NO asset/tex/32x32/bricks.xpm
SO asset/tex/32x32/spruce_planks.xpm
EA asset/tex/32x32/birch_planks.xpm
WE asset/tex/32x32/oak_planks.xpm

F 0,0,0 
C 255,255,255

11111111 1111111 111111111111
11111101 1000001 100000000001
11111111 1111111 111111111111
        1111111111111111111111111
        1000000000000000000000001
        1100000000000000000000001
        1000000000000000000000001
111111111000000000000000000000001
100000000000000000000000000001111
10000000000000N10000000000001
10000000000000000000000000001
10000000000000000000000000001
10000000000000000000000000001
10000000000000000001010000001
11000001110101011111011110101
11110111 1110111 101111010001
11111111 1111111 111111111111
0