NO asset/tex/32x32/bricks.xpm
SO asset/tex/32x32/spruce_planks.xpm
EA asset/tex/32x32/birch_planks.xpm
WE asset/tex/32x32/oak_planks.xpm

F 0,0,0 
C 255,255,255

11111111111111111111111 1111111111111111111111110
10000000001100000000001 100000000000000000000001
1000000001  100000000011100000000000000000000001
1000000001  100000000001000000000000000000000001
1000000001  100000000011100000000000000000000001
10000000001100000000001 100000000000000000000001
10000000000000000000001 100000000000000000000001
1111111111111111111111   11111111111110000000001
                                     10000000N01
1111111111111111111111   11111111111110000000001
10000000000000000000001 100000000000000000000001
100000000000000000000011100000000000000111111111
100000010000000000000000000000000000001         
1000001 1000000000000000000000000000000111111111
1000001 1000000000000000000000000000000000000001
1111111 1111111111111111111111111111111111111111