
NO	asset/tex/32x32/bricks.xpm
SO	asset/tex/32x32/spruce_planks.xpm
EA	asset/tex/32x32/birch_planks.xpm
WE	asset/tex/32x32/oak_planks.xpm

C   0,181,226
F   0,154,23

1111111111111111111
1000000000000000001
1000000000000000001
1000000000000000001
1000100000000000001
1000000000000000001
10000000N0000000001
1000000000000000001
1000000000000000001
1000000000000000001
1000000000000000001    111
1000000000000000001    1010
1111111111111111111    111
