NO asset/tex/32x32/bricks.xpm
SO asset/tex/32x32/spruce_planks.xpm
EA asset/tex/32x32/birch_planks.xpm
WE asset/tex/32x32/oak_planks.xpm

F 0,0,0 
C 255,255,255

        1111111110N0111111111111111
