NO asset/tex/32x32/bricks.xpm
SO asset/tex/32x32/spruce_planks.xpm
EA asset/tex/32x32/birch_planks.xpm
WE asset/tex/32x32/oak_planks.xpm

F 0,0,0 

111111111111111111111111111111111111111111111111
100000001111000000000000000000000000000000000001
100000010000111000000000000000000000000000000001
101000100001000110000000000000000000000000000001
101000100000100010000000000000011111110000000001
101000100000100010000000000011000000001110000001
101000100000100001000000001100000000000001100001
101000010000100000110001110000000000000000110001
101000011000010000001110000000111111000000011001
101000001100001000000000001110000001100000001101
100100000010000100000001100000000000010000000101
100110000001100001111110000000000000001000000001
100000000000011100000000000000011110000100000001
100000000000000001111111110000100000000011000101
110000000000000000000000000000000000000000111001
111111111111111111111111111111111111111111110111