
NO ./grey_cub.xpm
SO ./xpm/bluestone.xpm
EA ./xpm/colorstone.xpm
WE ./xpm/redbrick.xpm

C 255,100,160
F 111,111,111

11111111111111111
10000000000000001
10000000000000001
10000000000000001
10000000000000001
10000000000000001
10000000N00000001
10000000000000001
10001000100100001
10000000000000001
10100000100001001
10000000000000001
11111111111111111
