
NO ./grey_cub.xpm
SO ./xpm/bluestone.xpm
EA ./xpm/colorstone.xpm
WE ./xpm/redbrick.xpm

C 0,192,254
F 70,37,7

11111111111111111111111111111111111111111111111111111111111
10000000000000000000000000000000000000000000000000000000001
10000000000000000000000000000000000000000000000000000000001
10000000000000000000000000000000000000000000000000000000001
10000000000000000000000000000000000000000000000000000000001
10000000000000000000000000000000000000000000000000000000001
10000000000000000000000000000N00000000000000000000000000001
10000000000000000000000000000000000000000000000000000000001
10000000000000000000000000000000000000000000000000000000001
10000000000000000000000000000000000000000000000000000000001
10000000000000000000000000000000000000000000000000000000001
10000000000000000000000000000000000000000000000000000000001
11111111111111111111111111111111111111111111111111111111111
