
NO ./grey_cub.xpm
SO ./xpm/bluestone.xpm
EA ./xpm/colorstone.xpm
WE ./xpm/redbrick.xpm

C 0,0,0
F 70,37,7

1111111     1111111 
1     1     1 10S1       
1111111     1111111
